XXXXXXXXXXXXXXXXXXXX
X1213b31211X1221331X
X1231X11231X122X112X
X2331X21121X311X1c3X
X12XXX11123X3221211X
X1121321121XXXXXX22X
X1a2X1132311231XX12X
X111XXXXXXX12312X11X
X122X1132123d122112X
XXXXXXXXXXXXXXXXXXXX
